000000000000000000000000000000
0000000000M000000000000000000E
0000000000P00P000000000000000P
00000000000000000000000B000000
000000M000000M0000000000000000
000K00P000000P00P00P0000000000
000P00000000000000000000000000
00000000000000000000000P000000
0000000000M0000000M000000M0000
000000000000000000000000000000