000000000000000000000000000000
0000000000000000000000000000E0
000000000000K000000000000000P0
000000000000P00000000000000000
00000000000000000M000M000M0000
00000000000000000P000P000P0000
0000000M000000M000000000000000
0000P0P0P0P0P0P000000000000000
00000000000000000P000000000000
000000000000000000000000000000