00000000000000B000000000000000
E00B000P0000P0000P0000BK000000
P0000000000000000000000P000000
0000000000T0000000000000000000
0000000000B0000B00000B00000000
000000000000000000000000000000
00000P00P00000M000000000000000
00000P00000000P000000000000000
000P000M00M000000M000M00000M00
000000000000000000000000000000